UltrasonicSensor	KEYWORD1
IrSensor	KEYWORD1
BumpSwitch	KEYWORD1
LinearActuator	KEYWORD1
Motor	KEYWORD1
read	KEYWORD2
goUp	KEYWORD2
goDown	KEYWORD2
pause	KEYWORD2
turnOn	KEYWORD2
turnOff	KEYWORD2
goForward	KEYWORD2
goBackward	KEYWORD2
goForwardUntil	KEYWORD2
goBackwardUntil	KEYWORD2
PIDPos	KEYWORD2
PIDVel	KEYWORD2
getPos	KEYWORD2
getVel	KEYWORD2
getAcc	KEYWORD2
setPos	KEYWORD2
internalUpdate	KEYWORD2